################################
##                             #
###                            #
#                 ###          #
#                              #
#        ####                  #
#                              #
#                              #   
#                              #
#  ######     ##########       #
#                              #
#                              #
#       ##################     #
#                              #
#                              #
################################