#######################AA#######
##                             #
###                            #
#                 ###          #
#                              #
#        ####                  #
#                              #
# ###########                  #   
#                              #
#             #                #
#                              #
#         #                    #
#                      ###     #
#                              #
#                              #
#################################