$$$$$$@@@@@@@@@@@@@@EE@@@@@@@@@@
$$$$               ###         @
$$               ####          @
$               ###            @
@             #####            @
@         #####                @
@         ###                  @
@         ###                  @
@      ######                  @
@      #####                   @
@      #####                   @
@      #####                   @
@                             @@
@                            @@@
@                          @@@@@
@@@@@@@@@@@@@@@@@@@@@@@@@@@@@@@@
