########################A#######
##                             #
###                            #
#                 ###          #
#                              #
#        ####                  #
#                              #
# ###########               S  #   
#                              #
#                              #
#                              #
#                              #
#                      ###     #
#                              #
#                              #
#################################