$$$$$$$$$$$$$$$$$LLLL$$$$$$$$$$$
$$$$$$$$$$$$$$$$$%%%%$$$$$$$$$$$
$$$$$$$$$$$$$$$$$%%%%$$$$$$$$$$$
$$$$$$$$$$$$$$$$$%%%%$$$$$$$$$$$
@@@@@@           ####      @@@@@
@@               ####        @@@
@                ####          @
@                ####          @
@                ####          @
@                ####          @
@                ######        @
@                  ####        @
@                  ####        @
@@                 ####        @ 
@@@                ####        @
@@@@@@@@@@@@@@@@@@@@AA@@@@@@@@@@