$$$$$$@@@@@@@@@@@@@@@@@@@@@@@@@@
$$$$                           @
$$                             @
$                              @
@                              @
@                              @
@                              @
@                              @
@                              @
@                              @
@                              @
@                              @
@                             @@
@                            @@@
@                          @@@@@
@@@@@@@@@@@@@@@@@@@@@@@@@@@@@@@@
