$$$$$$$$$$$$$$$$$LLLL$$$$$$$$$$$
$$$$$$$$$$$$$$$$$%%%%$$$$$$$$$$$
$$$$$$$$$$$$$$$$$%%%%$$$$$$$$$$$
$$$$$$$$$$$$$$$$$%%%%$$$$$$$$$$$
$$$$$$$$$$$$$$$$$%%%%$$$$$$$$$$$
$$$$$$%%%%%%%%%%%%%%%$$$$$$$$$$$
$$$$$$%%%%%%%%%%%%%%%$$$$$$$$$$$
$$$$$$%%%%$$$$$$$%%%%$$$$$$$$$$$
$$$$$$%%%%$$$$$$$%%%%$$$$$$$$$$$
$$$$$$%%%%$$$$$$$%%%%$$$$$$$$$$$
$$$$$$%%%%$$$$$$$%%%%$$$$$$$$$$$
$$$$$$$$$$$$$$$$$%%%%$$$$$$$$$$$
$$$$$$$$$$$$$$$$$%%%%$$$$$$$$$$$
$$$$$$$$$$$$$$$$$%%%%$$$$$$$$$$$
$$$$$$$$$$$$$$$$$%%%%$$$$$$$$$$$
$$$$$$$$$$$$$$$$$DDDD$$$$$$$$$$$$