$$$$$$@@@@@@@@@@@@@@EE@@@@@@@@@@
$$$$               ###         @
$$               ####          @
$               ###            @
@             ####             @
@         #####                @
@         ###                  @
@         ##                   @
@     ######                   @
@    #######                   @
@      ####                    @
@      ###                     @
@                             @@
@                            @@@
@                          @@@@@
@@@@@@@@@@@@@@@@@@@@@@@@@@@@@@@@
