@@@@@@@@@@@@@@@@@LLLL@@@@@@@@@@@
@@@@@@@@@@@@@@@@@%%%%@@@@@@@@@@@
@@@@@@@@@@@@@@@@@%%%%@@@@@@@@@@@
@@@@@@@@@@@@@@@@@%%%%@@@@@@@@@@@
@@@@@@@@@@@@@@@@@%%%%@@@@@@@@@@@
@@@@@@@@@@@@@@@@@%%%%@@@@@@@@@@@
@@@@@@@@@@@@@@@@@%%%%@@@@@@@@@@@
@@@@@@@@@@@@@@@@@%%%%@@@@@@@@@@@
@@@@@@@@@@@@@@@@@%%%%$$@@@@@@@@@
@@@@@@@@@@@@@@@@@%%%%$$$$$@@@@@@
@@@@@@@@@@@@@@@@@%%%%$$@@@$$$$$@
@@@@@$$$$$@@$$$$$%%%%$$@@@$$$$$@
$$$$@@@@@$@@$$$$$%%%%$$@@@@@$$@@
$$$$@@@@@$$$$$$$$%%%%$$$$$@@@@@@
$$$$$$$$$$$$$$$$$%%%%$$$$$$$$$$$
$$$$$$$$$$$$$$$$$DDDD$$$$$$$$$$$$