                                
                                
                                
  XNNNNNNNNNNNNNNNNNNNNNNNNZ    
  mBBBBBBBBBBBBBBBBBBBBBBBBM    
NNmBBBBBBBBBBBBBBBBBBBBBBBBM    
YBBBBBBBBBBBBBBBBBBBBBBBBBBM    
YBBBBBBBBBBBBBBBBBBBBBBBBBBM    
YBBBBBBBBBBBBBBBBBBBBBBBBBBM    
nnmBBBBBBBBBBBBBBBBBBBBBBBBM    
  mBBBBBBBBBBBBBBBBBBBBBBBBM    
  mBBBBBBBBBBBBBBBBBBBBBBBBM    
  mBBBBBBBBBBBBBBBBBBBBBBBBM    
  mBBBBBBBBBBBBBBBBBBBBBBBBM    
  znnnnnnnmBBBMnnnnnnnnnnnnx    
          myyyM                  