                      PUUUUUp   
POOOOOOOOOOOOOOOOOOOOOOJJJJJOOOp
PJJJJJJJJP       pJJJJJJJJJJJJJp
PJJJJJJJJP       pJJJJJJJJJJJJJp
PJJJJJJJJP       pJJJJJJJJJJJJJp
PJJJJJJJJP       pJJJJJJJJJJJJJp
PJJJJJJJJP       pJJJJJJJJJJJJJp
PJJJJJJJJP       pJJJJJJJJJJJJJp
PJJJJJJJJOOOOOOOOOJJJJJJJJJJJJJp
PJJJJJJJJJJJJJJJJJJJJJJJJJJJJJJp
PJJJJJJJJJJJJJJJJJJJJJJJJJJJJJJp
PJJJJJJJJJJJJJJJJJJJJJJJJJJJJJJp
PJJJJJJJJJJJJJJJJJJJJJJJJJJJJJJp
PooooooooooKKKooooooooooooooooop
          PKKKp                 
          Puuup                  